10,0,1,1,0,-1,0,4,4,10
0,0,3,3,0,0,0,4,4,0
0,0,3,3,0,0,0,11,0,0
-1,0,11,1,0,0,1,0,0,-1
0,0,0,0,0,0,0,0,0,0
0,0,0,0,0,13,0,0,0,0
0,0,11,1,0,0,1,0,0,0
0,0,4,4,0,0,0,0,0,0
0,0,4,4,0,0,0,0,11,0
10,0,4,4,0,-1,3,3,0,10
