5,11,4,0,0,0,0,0,13,13
11,11,4,0,0,0,15,0,0,0
4,4,4,0,0,0,0,15,0,0
0,0,0,3,3,3,0,0,0,0
0,0,0,3,13,3,0,0,16,0
0,0,0,3,1,3,0,1,1,1
0,15,0,3,3,3,0,0,0,0
0,0,15,0,0,0,1,0,0,0
0,0,0,0,0,0,1,0,-1,-1
0,0,0,0,0,16,1,0,-1,-1
