10,0,0,0,0,0,3,12,3,0,0,0,0,0,10
0,13,0,0,0,0,0,3,0,0,0,0,0,13,0
0,4,4,4,0,0,0,0,0,0,0,4,4,4,0
0,4,1,4,0,0,0,0,0,0,0,4,1,4,0
0,4,4,4,1,3,3,3,3,3,1,4,4,4,0
0,0,0,0,3,1,1,0,1,1,3,0,0,0,0
3,0,0,0,3,1,-1,0,-1,1,3,0,0,0,3
12,3,0,0,3,0,0,0,0,0,3,0,0,3,12
3,0,0,0,3,1,-1,0,-1,1,3,0,0,0,3
0,0,0,0,3,1,1,0,1,1,3,0,0,0,0
0,4,4,4,1,3,3,3,3,3,1,4,4,4,0
0,4,1,4,0,0,0,0,0,0,0,4,1,4,0
0,4,4,4,0,0,0,0,0,0,0,4,4,4,0
0,13,0,0,0,0,0,3,0,0,0,0,0,13,0
10,0,0,0,0,0,3,12,3,0,0,0,0,0,10
